1111111111111111111111111111111111111111
1P01000010001110011000111001000010000111
1001001000111110111010001001001000111111
10011110111000001110111000011110111000E1
10000010000C11100000001110000010C0000111
100100110011001101111000C001001100110001
1001000000110000011000011001000000111001
1111111111100111011001111111111111100011
1110000000000111C110000001100000000C0011
1111111111111111111111111111111111111111