1111111111111111111111111111111111111111
1P010000100C1110C11000111C0100001000C111
1001C01000111110111010001001C01000111111
10011110111000001110111000011110111000E1
1000001000001110000000111000001000000111
100100110011001101111000C001001100110001
1C0100000C11000001100001100100000C111001
1111111111100111011001111111111111100011
111C000000000111C1100000C11C000000000011
1111111111111111111111111111111111111111